Level 7 (merci à E. Porte)
32
########
####D ##
#### L #
# K#BBB#
#MB MB #
# #M  H#
#U##T###
#TUTU###
########
