Level 8 (merci à G. Héricourt)
12
###########
#  ##D##  #
#    M    #
#    M    #
#  # M #  #
#    M    #
#  # M #  #
#    M    #
## # M # ##
##   M   ##
## #   # ##
##   H   ##
####   ####
###########
